room_9_3,
COLUMNS=20,LINES=11,
SET_MOB=222 ,
SPAWN flying: 1-17
SPAWN flying: 1-18
SPAWN flying: 9-1
WWWWWWWWWWWWWWWWWWWW
WJJJFFFFFFFFBFFFF22W
WJFFFFFFFFFFBFFFFFFW
WFFFFFFFFFFFBFBBBBBW
WFFFFFFFFFFFFFFFFFFW
WFFFFFFFFJFFFFFFFFFW
WFFFFFFFFFJFFFFFFFFW
WFFFFFFFFFFFFFFFFFFW
WBBBBFBFFFFFFFFFFJJW
W2FFFFBFFFFFFFFJJJJW
WWWWWWWWWWWWWWWWWWWW
