room_8_1,
COLUMNS=20,LINES=11,
SET_MOB=33 ,
SPAWN ground: 5-8
SPAWN ground: 5-11
WWWWWWWWWWWWWWWWWWWW
WFFFFFFFFFFFFFFFFFFW
WFBBJFFFBBBBFFFJBBFW
WFBFFFFFFFFFFFFFFBFW
WFFFFFFFFFFFFFFFFFFW
WFBFFFFF3FF3FFFFFBFW
WFFFFFFFFFFFFFFFFFFW
WFBFFFFFFFFFFFFFFBFW
WFBBJFFFBBBBFFFJBBFW
WFFFFFFFFFFFFFFFFFFW
WWWWWWWWWWWWWWWWWWWW
