room_19_3,
COLUMNS=20,LINES=11,
SET_MOB=02201 ,
SPAWN flying: 1-2
SPAWN flying: 5-9
SPAWN flying: 5-10
SPAWN flying: 8-5
SPAWN ground: 9-17
WWWWWWWWWWWWWWWWWWWW
WB0BHFFFFFFFBBFFFFFW
WBHHHFFFFFFFFBBFFFFW
WHFFFFFFFFFFFFBBBBBW
WFFFFFFFFBBFFFFFFFFW
WFFFFFFFB22BFFFFFFFW
WFFFFFFFFBBFFFFFFFFW
WFFFBBBFFFFFFFFFHHJW
WBBJF0BFFFFFFFFFHFFW
WFFFFFBBFFFFFFFFH1FW
WWWWWWWWWWWWWWWWWWWW
