room_1_1,
COLUMNS=20,LINES=11,
SET_MOB=3333 ,
SPAWN ground: 4-7
SPAWN ground: 4-12
SPAWN ground: 6-7
SPAWN ground: 6-12
WWWWWWWWWWWWWWWWWWWW
WFFFFFFFFFFFFFFFFFFW
WFFFFFFFFFFFFFFFFFFW
WFFBFFBBBFBBBBFFBFFW
WFFBFFB3FFFF3BFFBFFW
WFFBFFFFFFFFFFFFBFFW
WFFBFFB3FFFF3BFFBFFW
WFFBFFBBBBFBBBFFBFFW
WFFFFFFFFFFFFFFFFFFW
WFFFFFFFFFFFFFFFFFFW
WWWWWWWWWWWWWWWWWWWW
