room_19_4,
COLUMNS=20,LINES=11,
SET_MOB=20020 ,
SPAWN flying: 1-2
SPAWN flying: 2-14
SPAWN flying: 5-9
SPAWN flying: 5-10
SPAWN flying: 9-17
WWWWWWWWWWWWWWWWWWWW
WF2HFFFFFFFFBBFFFFFW
WFFHFFFFFFFFFB0BBBBW
WHHHFFFFFFFFFBBBFFFW
WFFFFFFFFBBFFFFFFFFW
WFFFFFFFB02BFFFFFFFW
WJFFFFFFFBBFFFFFFFFW
WJJJJJFFFFFFFFFFFHHW
WBBBBJJJFFFFFFFHHHBW
WBBBBBBJJFFFFFFHB0BW
WWWWWWWWWWWWWWWWWWWW
