room_3_2,
COLUMNS=20,LINES=11,
SET_MOB=222222 ,
SPAWN flying: 4-7
SPAWN flying: 4-12
SPAWN flying: 5-9
SPAWN flying: 5-10
SPAWN flying: 6-7
SPAWN flying: 6-12
WWWWWWWWWWWWWWWWWWWW
WHHHHHHHHFFHHHHHHHHW
WHFFFFFFFFFFFFFFFBHW
WHFFFFFFFFFFFFFFFFHW
WHFFFFB2FFFF2BFFFFHW
WFFFFBBFF22FFBBFFFFW
WHFFFFB2FFFF2BFFFFHW
WHFFFFFFFFFFFFFFFFHW
WHBFFFFFFFFFFFFFFFHW
WHHHHHHHHFFHHHHHHHHW
WWWWWWWWWWWWWWWWWWWW
