room_13_1,
COLUMNS=20,LINES=11,
SET_MOB=0103 ,
SPAWN flying: 1-17
SPAWN ground: 5-8
SPAWN flying: 7-7
SPAWN ground: 8-17
WWWWWWWWWWWWWWWWWWWW
WFFFFFFFFFFFFFFFF0FW
WFHHHHHHHHHHHHHHHFFW
WFHFFFFFFFFFFFFFFFFW
WFHFFFFFFFFFFFFFFFFW
WFHFFFFF1FFFFFFFFFFW
WFHFFFFFFFFFFFFFFFFW
WFHFFFF0FFFFFFFFFFFW
WFFFFFFFFFFFFFFFF3FW
WFFFFFFFFFFFFFFFFFFW
WWWWWWWWWWWWWWWWWWWW
