room_19_2,
COLUMNS=20,LINES=11,
SET_MOB=0101 ,
SPAWN flying: 1-2
SPAWN ground: 1-15
SPAWN flying: 8-5
SPAWN ground: 9-17
WWWWWWWWWWWWWWWWWWWW
WB0BJFFFFFFFBFF1JFFW
WJJJJFFFFFFFFHHFFFFW
WJFFFFFFFFFFFFHHHHJW
WFFFFFFFFBBFFFFFFFFW
WFFFFFFFBFFBFFFFFFFW
WFFFFFFFFBBFFFFFFFFW
WFFFHHHFFFFFFFFFHHJW
WBHJF0HFFFFFFFFFHFFW
WFFFFFHFFFFFFFFFH1FW
WWWWWWWWWWWWWWWWWWWW
