room_13_4,
COLUMNS=20,LINES=11,
SET_MOB=20112 ,
SPAWN flying: 2-17
SPAWN flying: 5-5
SPAWN ground: 5-9
SPAWN ground: 7-12
SPAWN flying: 8-2
WWWWWWWWWWWWWWWWWWWW
WFFFFFFFFFFFFFFFFFFW
WFBBBFHHHHHHHHHHF2FW
WFFFFFFFFFFFFFFFFFFW
WFBFFFFFFFFFFFFFFHFW
WFBFF0FFF1FFFFFFFHFW
WFBFFFFJFFFFFFFFFBFW
WFFFFFFFFFFF1FFFJBFW
WF2FFFFFFFFFFFFFFBFW
WFFFFFFFFFFFFFFFFFFW
WWWWWWWWWWWWWWWWWWWW
