room_9_1,
COLUMNS=20,LINES=11,
SET_MOB=222 ,
SPAWN flying: 1-18
SPAWN flying: 9-1
SPAWN flying: 9-2
WWWWWWWWWWWWWWWWWWWW
WJJJJFFFFFFFFBFFFF2W
WJJFFFFFFFFFFBFBBBBW
WFFFFFFFFFFFFFFFFFFW
WFFFFFFFFJFFFFFFFFFW
WFFFFFFFFFJFFFFFFFFW
WFFFFFFFFFFFFFFFFFFW
WBBBBBFBFFFFFFFFFFFW
WFFFFFFBFFFFFFFFFFJW
W22FFFFBFFFFFFFFJJJW
WWWWWWWWWWWWWWWWWWWW
