room_15_3,
COLUMNS=20,LINES=11,
SET_MOB=131 ,
SPAWN ground: 4-14
SPAWN ground: 5-9
SPAWN ground: 6-4
WWWWWWWWWWWWWWWWWWWW
WFFFFFFFFFFFFFFFFFJW
WFBBFFFBFFFFFFFHHHFW
WJBFFFFFFFFFFFFFFHFW
WFFFFFFFFFFFFF1FFHFW
WFFFFFFFF3BFFFFFFFFW
WFBF1FFFFBFFFFFFFHFW
WFBFFFFFFFFFFFFFFHJW
WFBBBBFFFFFFFHHFHHFW
WFFJFFFFFFFFFJFFFJFW
WWWWWWWWWWWWWWWWWWWW
