room_7_4,
COLUMNS=20,LINES=11,
SET_MOB=000000 ,
SPAWN flying: 1-1
SPAWN flying: 1-18
SPAWN flying: 5-9
SPAWN flying: 5-10
SPAWN flying: 9-1
SPAWN flying: 9-18
WWWWWWWWWWWWWWWWWWWW
W0BBBBJFFFFFFJBBBB0W
WBBBJJFFFFFFFFJJBBBW
WBJJFFFFFFFFFFFFJJBW
WJFFFFFFFHHFFFFFFFJW
WFFFFFFFH00HFFFFFFFW
WJFFFFFFFHHFFFFFFFJW
WBJJFFFFFFFFFFFFJJBW
WBBBJJFFFFFFFFJJBBBW
W0BBBBJFFFFFFJBBBB0W
WWWWWWWWWWWWWWWWWWWW
