room_10_1,
COLUMNS=20,LINES=11,
SET_MOB=2121 ,
SPAWN flying: 1-16
SPAWN ground: 2-3
SPAWN flying: 6-11
SPAWN ground: 8-3
WWWWWWWWWWWWWWWWWWWW
WBFFFFFHBFFFFFFB2FFW
WBB1FFFHFFFFFFFFFFFW
WBBBBFFHFFFFFFFFFFFW
WFFFFFFFFFFFFFFFFFBW
WFFFFFFFFFFBFFFFFFFW
WFFFFFFFFFF2FFFFFFFW
WBBBBFFHFFFFFBFFFFFW
WBB1FFFHFFFFFFFFFFFW
WBFFFFFHFFFFFFFBFFFW
WWWWWWWWWWWWWWWWWWWW
