room_11_3,
COLUMNS=20,LINES=11,
SET_MOB=2012 ,
SPAWN flying: 1-1
SPAWN flying: 1-17
SPAWN ground: 8-2
SPAWN flying: 9-18
WWWWWWWWWWWWWWWWWWWW
W2FFHFFFFFFFHFFFF0FW
WFFFHFFFFFFFHHHHHHHW
WHHHFFFFFFFFFFFFFFFW
WFFFFFFFJFFFFFFFFFFW
WFFFJFFFFFFJFFFFFFFW
WJFFFFFFFJFFFFFFFFBW
WJJJJFFFFFFFFFFFFBBW
WJ1JFFFFFFFFFFFFBBBW
WJJJFJFFFFFFFFFBBB2W
WWWWWWWWWWWWWWWWWWWW
