room_test,
COLUMNS=20,LINES=11,
SET_MOB=00 ,
SPAWN flying: 5-9
SPAWN flying: 5-10
WWWWWWWWWWWWWWWWWWWW
WFFFFFFFFFFFFFFFFFFW
WFFFFFFFFFFFFFFFFFFW
WFFFFFFFFFFFFFFFFFFW
WFFFFFFFHFFHFFFFFFFW
WFFFFFFFH00HFFFFFFFW
WFFFFFFFHFFHFFFFFFFW
WFFFFFFFFFFFFFFFFFFW
WFFFFFFFFFFFFFFFFFFW
WFFFFFFFFFFFFFFFFFFW
WWWWWWWWWWWWWWWWWWWW
