room_1_3,
COLUMNS=20,LINES=11,
SET_MOB=1111 ,
SPAWN ground: 4-7
SPAWN ground: 4-12
SPAWN ground: 6-7
SPAWN ground: 6-12
WWWWWWWWWWWWWWWWWWWW
WFFFFFFFFFFFFFFFFFFW
WFFFFFFJJFFJJFFFFFFW
WFFBFFFBBBBBBFFFBFFW
WFFBFFF1FFFF1FFFBFFW
WFBBJFFFFFFFFFFJBBFW
WFFBFFF1FFFF1FFFBFFW
WFFBFFFBBBBBBFFFBFFW
WFFFFFFJJFFJJFFFFFFW
WFFFFFFFFFFFFFFFFFFW
WWWWWWWWWWWWWWWWWWWW
