room_15_1,
COLUMNS=20,LINES=11,
SET_MOB=0000 ,
SPAWN flying: 1-4
SPAWN flying: 1-16
SPAWN flying: 7-3
SPAWN flying: 9-16
WWWWWWWWWWWWWWWWWWWW
WFFJ0FFFFFFFJJFF0JFW
WJHHHHFFFFFFFHHHHHFW
WFHFFFFFFFFFFFFFFHJW
WFHFFFFFFBFFFFFFFHFW
WFFFFFFFFBBFFFFFFFFW
WFHFFFFFFFFFFFFFFHFW
WJH0FFFFFFFFFFFFFHFW
WFHHHHHHFFHHFFFHHHFW
WFFJJJFFFFFFFJFF0FJW
WWWWWWWWWWWWWWWWWWWW
