room_1_2,
COLUMNS=20,LINES=11,
SET_MOB=3333 ,
SPAWN ground: 4-7
SPAWN ground: 4-12
SPAWN ground: 6-7
SPAWN ground: 6-12
WWWWWWWWWWWWWWWWWWWW
WFFFFFFFFFFFFFFFFFFW
WFFFFFFJJFFJJFFFFFFW
WFFBFFFBBBBBBFFFBFFW
WFFBFFF3FFFF3FFFBFFW
WFFBJFFFFFFFFFFJBFFW
WFFBFFF3FFFF3FFFBFFW
WFFBFFFBBBBBBFFFBFFW
WFFFFFFJJFFJJFFFFFFW
WFFFFFFFFFFFFFFFFFFW
WWWWWWWWWWWWWWWWWWWW
