room_16_4,
COLUMNS=20,LINES=11,
SET_MOB=01021 ,
SPAWN flying: 1-1
SPAWN ground: 2-18
SPAWN flying: 7-13
SPAWN flying: 9-1
SPAWN ground: 9-16
WWWWWWWWWWWWWWWWWWWW
W0FFBFFFFFFFFFFBFFFW
WFBBFFFFFFFFFFFFBB1W
WBFFJFFFFFFFJFFFFFBW
WFFFFFFFFJFFFFFFFFFW
WFFFFFFFFJJFFFFFFFFW
WFFJFFFFFFFFFFFFFFFW
WFFFFFFJFFFJF0FFFFFW
WHFFFFFFFFFFFFFFFJFW
W2HFFFFFFFFFFFFH1FFW
WWWWWWWWWWWWWWWWWWWW
