room_15_2,
COLUMNS=20,LINES=11,
SET_MOB=0202 ,
SPAWN flying: 1-16
SPAWN flying: 3-3
SPAWN flying: 9-4
SPAWN flying: 9-16
WWWWWWWWWWWWWWWWWWWW
WFFJJJFFFFFFFJFF0FJW
WFHHHHHHFFFFFFFHHHFW
WJH2FFFFFFFFFFFFFHFW
WFFFFFFFFFFFFFFFFHFW
WFFFFFFFFFBFFFFFFFFW
WFHFFFFFFBFFFFFFFHFW
WFHFFFFFFFFFFFFFFHJW
WJHHHHFFFFFFFHHFHHFW
WFFJ0FFFFFFFJJFF2JFW
WWWWWWWWWWWWWWWWWWWW
