room_7_1,
COLUMNS=20,LINES=11,
SET_MOB=0330 ,
SPAWN flying: 2-4
SPAWN ground: 2-15
SPAWN ground: 8-4
SPAWN flying: 8-15
WWWWWWWWWWWWWWWWWWWW
WBBBBFFFFFFFFFFBBBBW
WBBB0FFFFFFFFFF3BBBW
WBFFFFFFFFFFFFFFFFBW
WFFFFFFFFHHFFFFFFFFW
WFFFFFFFHHHHFFFFFFFW
WFFFFFFFFHHFFFFFFFFW
WBFFFFFFFFFFFFFFFFBW
WBBB3FFFFFFFFFF0BBBW
WBBBBFFFFFFFFFFBBBBW
WWWWWWWWWWWWWWWWWWWW
