room_12_1,
COLUMNS=20,LINES=11,
SET_MOB=0022 ,
SPAWN flying: 1-2
SPAWN flying: 1-17
SPAWN flying: 8-18
SPAWN flying: 9-2
WWWWWWWWWWWWWWWWWWWW
WF0FHFFFFFFFFFFHF0FW
WFFFHFFFFFFFFFFHFFFW
WFFFFHFFFFFFFFHFFFFW
WFFFFFHHFFFFHHFFFFFW
WFFFFFFFHFFHFFFFFFFW
WFFFFFFFFFFFFFFFFFFW
WFFFFFFFFFFFFFFFFFFW
WFFFFFFFFFFFFFFFFF2W
WF2FFFFFFFFFFFFFFFFW
WWWWWWWWWWWWWWWWWWWW
