room_18_1,
COLUMNS=20,LINES=11,
SET_MOB=2330 ,
SPAWN flying: 1-3
SPAWN ground: 4-9
SPAWN ground: 6-6
SPAWN flying: 8-17
WWWWWWWWWWWWWWWWWWWW
WBF2FFFHFFFFFJJJJJFW
WFBFFHHFFFFFFFFJJFFW
WFFFHFFFFFFJFFFFFJFW
WHHHFFFFF3FFFFFFFFFW
WFFFFFFFFFFFFFFFFFFW
WFFFFF3FFFFFFFFFHHHW
WBFFFFFFFFFFFFFHFFBW
WBFFFFFFFFFFFHHFF0FW
WBBFFFFFFFFFHBFFFFFW
WWWWWWWWWWWWWWWWWWWW
