room_2_1,
COLUMNS=20,LINES=11,
SET_MOB=3333 ,
SPAWN ground: 4-7
SPAWN ground: 4-12
SPAWN ground: 6-7
SPAWN ground: 6-12
WWWWWWWWWWWWWWWWWWWW
WJJFFFFFFFFFFFFFFJJW
WJFFFFFFFFFFFFFFFFJW
WFFFFFFBBFFBBFFFFFFW
WFFFFFF3BFFB3FFFFFFW
WFFFFFFFBFFBFFFFFFFW
WFFFFFF3BFFB3FFFFFFW
WFFFFFFBBFFBBFFFFFFW
WJFFFFFFFFFFFFFFFFJW
WJJFFFFFFFFFFFFFFJJW
WWWWWWWWWWWWWWWWWWWW
