room_5_4,
COLUMNS=20,LINES=11,
SET_MOB=3113 ,
SPAWN ground: 2-2
SPAWN ground: 2-17
SPAWN ground: 8-2
SPAWN ground: 8-17
WWWWWWWWWWWWWWWWWWWW
WJJFBBFBFFFFBFBBFJJW
WJ3FFBFFFFFFFFBFF1JW
WFFFFBFFFFFFFFBFFFFW
WFFFFFFFFHHFFFFFFFFW
WFFFFFFFHHHHFFFFFFFW
WFFFFFFFFHHFFFFFFFFW
WFFFFBFFFFFFFFBFFFFW
WJ1FFBFFFFFFFFBFF3JW
WJJFBBFBFFFFBFBBFJJW
WWWWWWWWWWWWWWWWWWWW
