room_6_2,
COLUMNS=20,LINES=11,
SET_MOB=22 ,
SPAWN flying: 2-5
SPAWN flying: 8-14
WWWWWWWWWWWWWWWWWWWW
WBBBBJFFFFFFFFJBBBBW
WJBBJ2FFFFFFFFFJBBJW
WFJJFFFFFFFFFFFFJJFW
WFFFFFFFBBBBFFFFFFFW
WFFFFFFFBHHBFFFFFFFW
WFFFFFFFBBBBFFFFFFFW
WFJJFFFFFFFFFFFFJJFW
WJBBJFFFFFFFFF2JBBJW
WBBBBJFFFFFFFFJBBBBW
WWWWWWWWWWWWWWWWWWWW
