room_7_2,
COLUMNS=20,LINES=11,
SET_MOB=222222 ,
SPAWN flying: 2-4
SPAWN flying: 2-15
SPAWN flying: 5-9
SPAWN flying: 5-10
SPAWN flying: 8-4
SPAWN flying: 8-15
WWWWWWWWWWWWWWWWWWWW
WBBBBBFFFFFFFFBBBBBW
WBBB2FFFFFFFFFF2BBBW
WBFFFFFFFFFFFFFFFFBW
WFFFFFFFFHHFFFFFFFFW
WFFFFFFFH22HFFFFFFFW
WFFFFFFFFHHFFFFFFFFW
WBFFFFFFFFFFFFFFFFBW
WBBB2FFFFFFFFFF2BBBW
WBBBBBFFFFFFFFBBBBBW
WWWWWWWWWWWWWWWWWWWW
