room_18_3,
COLUMNS=20,LINES=11,
SET_MOB=1311 ,
SPAWN ground: 2-15
SPAWN ground: 4-10
SPAWN ground: 5-9
SPAWN ground: 7-3
WWWWWWWWWWWWWWWWWWWW
WJJJJJFFJFFFHFFHFHHW
WJFJFFFFFFFFFHH1FBFW
WFFFFFFFJFFFFFFHFFFW
WFFFFFFFFF3FFFFFHHHW
WFFJFFFFF1FFFFFFFFFW
WHHHFFFFFFFFFFFFFFFW
WBF1HFFFFFFFFFFFFFBW
WFFFFHHFFFFFFFFFFFBW
WHHFFFBHFFFFFFFFFBBW
WWWWWWWWWWWWWWWWWWWW
