room_2_3,
COLUMNS=20,LINES=11,
SET_MOB=00 ,
SPAWN flying: 5-9
SPAWN flying: 5-10
WWWWWWWWWWWWWWWWWWWW
WJJFFFFFFFFFFFFFFJJW
WJFFFFFFBBBBFFFFFFJW
WFFFBFFFFFFFFFFBFFFW
WFFFBFFFFFFFFFFBFFFW
WFFFHFFFF00FFFFHFFFW
WFFFBFFFFFFFFFFBFFFW
WFFFBFFFFFFFFFFBFFFW
WJFFFFFFBBBBFFFFFFJW
WJJFFFFFFFFFFFFFFJJW
WWWWWWWWWWWWWWWWWWWW
