room_8_3,
COLUMNS=20,LINES=11,
SET_MOB=0000 ,
SPAWN flying: 3-9
SPAWN flying: 3-11
SPAWN flying: 7-8
SPAWN flying: 7-10
WWWWWWWWWWWWWWWWWWWW
WFFFFFFFFFFFFFFFFFFW
WFBBFFFFBBBBFFFFBBFW
WFBFFFFFH0F0FFFFFBFW
WFFFFFFFHFFFFFFFFFFW
WFFFFFFFFHHFFFFFFFFW
WFFFFFFFFFFHFFFFFFFW
WFBFFFFF0F0HFFFFFBFW
WFBBFFFFBBBBFFFFBBFW
WFFFFFFFFFFFFFFFFFFW
WWWWWWWWWWWWWWWWWWWW
