room_1_4,
COLUMNS=20,LINES=11,
SET_MOB=3333 ,
SPAWN ground: 4-7
SPAWN ground: 4-12
SPAWN ground: 6-7
SPAWN ground: 6-12
WWWWWWWWWWWWWWWWWWWW
WFFFFFFFFFFFFFFFFFFW
WFFFFFFFFFFFFFFFFFFW
WFFBFFBBBBFBBBFFBFFW
WFFBFFB3FFFF3BFFBFFW
WFFBFFFFFFFFFFFFBFFW
WFFBFFB3FFFF3BFFBFFW
WFFBFFBBBFBBBBFFBFFW
WFFFFFFFFFFFFFFFFFFW
WFFFFFFFFFFFFFFFFFFW
WWWWWWWWWWWWWWWWWWWW
