room_17_4,
COLUMNS=20,LINES=11,
SET_MOB=21201 ,
SPAWN flying: 1-18
SPAWN ground: 4-7
SPAWN flying: 5-6
SPAWN flying: 5-13
SPAWN ground: 6-12
WWWWWWWWWWWWWWWWWWWW
WBFFFFFFFFFFFFFFFB2W
WBFFFFFFFFFFFFFFFFBW
WFFFFFHHFFFFHHFFFFFW
WFFFHHF1HHHHFFHHFFFW
WFFHFF2FFFFFF0FFHFFW
WFFFHHFFHHHH1FHHFFFW
WFFFFFHHFFFFHHFFFFFW
WFFFFFFFFFFFFFFFFFBW
WBFFFFFFFFFFFFFFBFFW
WWWWWWWWWWWWWWWWWWWW
