room_14_1,
COLUMNS=20,LINES=11,
SET_MOB=211 ,
SPAWN flying: 1-2
SPAWN ground: 3-7
SPAWN ground: 3-14
WWWWWWWWWWWWWWWWWWWW
WF2FFFFFBFFBFFFFFFFW
WFFFFFFFHFFHFFFFFFFW
WFFFFFF1HFFHFF1FFFFW
WBHHHHHHHFFHHHHHHHBW
WFFFFFFFFFFFFFFFFFFW
WFFFFFFFFFFFFFFFFFFW
WJFFFFFFFFFFFFFFFBBW
WJJFFFFFFFFFFFFFBBBW
WJJJFFFFFFFFFFFBBBBW
WWWWWWWWWWWWWWWWWWWW
