room_16_1,
COLUMNS=20,LINES=11,
SET_MOB=0330 ,
SPAWN flying: 1-1
SPAWN ground: 4-7
SPAWN ground: 8-18
SPAWN flying: 9-1
WWWWWWWWWWWWWWWWWWWW
W0FFBFFFFFFFFFFBFFFW
WFBBFFFFFFFFFFFFBBFW
WBFFFFHHFFFFFFFFFFBW
WFFFFFH3FFFFFFFFFFFW
WFFFFFFFFFFFFFFFFFFW
WFFFFFFFFFFFFFFFFFFW
WFFFFFFFFFFFHFFFFFFW
WHFFFFFFFFFFFFFFFF3W
W0HFFFFFFFFFFFFFFFFW
WWWWWWWWWWWWWWWWWWWW
