room_18_2,
COLUMNS=20,LINES=11,
SET_MOB=23130 ,
SPAWN flying: 1-16
SPAWN ground: 4-10
SPAWN ground: 5-9
SPAWN ground: 6-13
SPAWN flying: 8-2
WWWWWWWWWWWWWWWWWWWW
WJJJJJFFJFFFHFFF2FBW
WJFJFFFFFFFFFHHFFBFW
WFFFFFFFJFFFFFFHFFFW
WFFFFFFFFF3FFFFFHHHW
WFFJFFFFF1FFFFFFFFFW
WHHHFFFFFFFFF3FFFFFW
WBFFHFFFFFFFFFFFFFBW
WF0FFHHFFFFFFFFFFFBW
WFFFFFBHFFFFFFFFFBBW
WWWWWWWWWWWWWWWWWWWW
