room_11_2,
COLUMNS=20,LINES=11,
SET_MOB=311 ,
SPAWN ground: 2-2
SPAWN ground: 2-15
SPAWN ground: 8-2
WWWWWWWWWWWWWWWWWWWW
WBFFFFFFFFFFFFHFFFFW
WF3FFFFFFFFFFFH1FFFW
WFFFFFFFFFFFFFFHHHHW
WFFFFFFFJFFFFFFFFFFW
WFFFFFFFFFFJFFFFFFFW
WFFFFFFFFJFFFFFFFFBW
WJFFFFFFFFFFFFFFJBBW
WJ1FFFFFFFFFFFFFBBBW
WJJJFFFFFFFFFFFBBBBW
WWWWWWWWWWWWWWWWWWWW
