room_8_2,
COLUMNS=20,LINES=11,
SET_MOB=22 ,
SPAWN flying: 5-6
SPAWN flying: 5-13
WWWWWWWWWWWWWWWWWWWW
WFFFFFFFFFFFFFFFFFFW
WFBBJFFFBBBBFFFJBBFW
WFBFFFFFFFFFFFFFFBFW
WFHFFFFFFFFFFFFFFHFW
WFBFFF2FFFFFF2FFFBFW
WFHFFFFFFFFFFFFFFHFW
WFBFFFFFFFFFFFFFFBFW
WFBBJFFFBBBBFFFJBBFW
WFFFFFFFFFFFFFFFFFFW
WWWWWWWWWWWWWWWWWWWW
