room_12_2,
COLUMNS=20,LINES=11,
SET_MOB=2200 ,
SPAWN flying: 1-2
SPAWN flying: 2-18
SPAWN flying: 9-2
SPAWN flying: 9-17
WWWWWWWWWWWWWWWWWWWW
WF2FFFFFJFFFFFFJFFFW
WFFJFFFFFFFJFFFFFF2W
WFFFFFFFFFFFFFFFFFFW
WFFFFFFFFFFFFFFFFFFW
WFFFFFJJHJJHJJFFFFFW
WFFFFJHHFFFFHHJFFFFW
WFFFJHFFFFFFFFHJFFFW
WFFFHFFFFFFFFFFHFFFW
WF0FHFFFFFFFFFFHF0FW
WWWWWWWWWWWWWWWWWWWW
