room_3_3,
COLUMNS=20,LINES=11,
SET_MOB=000000 ,
SPAWN flying: 4-7
SPAWN flying: 4-12
SPAWN flying: 5-9
SPAWN flying: 5-10
SPAWN flying: 6-7
SPAWN flying: 6-12
WWWWWWWWWWWWWWWWWWWW
WHHHHHHHHFFHHHHHHHHW
WHFFFFFFFFFFFFFFFBHW
WHFFFFFFFFFFFFFFFFHW
WHFFFFB0FFFF0BFFFFHW
WFFFFBBFF00FFBBFFFFW
WHFFFFB0FFFF0BFFFFHW
WHFFFFFFFFFFFFFFFFHW
WHBFFFFFFFFFFFFFFFHW
WHHHHHHHHFFHHHHHHHHW
WWWWWWWWWWWWWWWWWWWW
