room_4_1,
COLUMNS=20,LINES=11,
SET_MOB=3333 ,
SPAWN ground: 3-6
SPAWN ground: 3-13
SPAWN ground: 7-6
SPAWN ground: 7-13
WWWWWWWWWWWWWWWWWWWW
WBBFFFFFFFFFFFFFFBBW
WBFFFFFFFFFFFFFFFFBW
WFFFFF3BFFFFB3FFFFFW
WFBBFFBFFFFFFBFFBBFW
WFFBFFBFFFFFFBFFBFFW
WFBBFFBFFFFFFBFFBBFW
WFFFFF3BFFFFB3FFFFFW
WBFFFFFFFFFFFFFFFFBW
WBBFFFFFFFFFFFFFFBBW
WWWWWWWWWWWWWWWWWWWW
