room_5_3,
COLUMNS=20,LINES=11,
SET_MOB=0110 ,
SPAWN flying: 2-2
SPAWN ground: 2-17
SPAWN ground: 8-2
SPAWN flying: 8-17
WWWWWWWWWWWWWWWWWWWW
WJJFBBFFFFFFFFBBFJJW
WJ0FFBFFFFFFFFBFF1JW
WFFFFBFFFFFFFFBFFFFW
WFFFFFFFFHHFFFFFFFFW
WFFFFFFFHHHHFFFFFFFW
WFFFFFFFFHHFFFFFFFFW
WFFFFBFFFFFFFFBFFFFW
WJ1FFBFFFFFFFFBFF0JW
WJJFBBFFFFFFFFBBFJJW
WWWWWWWWWWWWWWWWWWWW
