room_10_4,
COLUMNS=20,LINES=11,
SET_MOB=2101 ,
SPAWN flying: 1-16
SPAWN ground: 2-3
SPAWN flying: 6-11
SPAWN ground: 8-3
WWWWWWWWWWWWWWWWWWWW
WBFFFFFHFFFFHFFF2FFW
WBB1FFFHFFFFHFFFFFFW
WBBBBFFHFFFFHFFBFFFW
WFFFFFFFFFFFFFFFFFFW
WFFFFFFFJFFFFFFFBFFW
WFFFFFFFFFF0FFFFFFBW
WBBBBFFHFFFFHFBFFFFW
WBB1FFFHFFFFHFFFFBFW
WBFFFFFHFFFFHFFFFFFW
WWWWWWWWWWWWWWWWWWWW
