room_17_3,
COLUMNS=20,LINES=11,
SET_MOB=32003 ,
SPAWN ground: 1-1
SPAWN flying: 1-18
SPAWN flying: 5-6
SPAWN flying: 5-13
SPAWN ground: 9-17
WWWWWWWWWWWWWWWWWWWW
W3FFFFFFFFFFFFFFFB2W
WFFFFFFFFFFFFFFFFFBW
WFFFFFHHHHHHHHFFFFFW
WFFFHHFFFFFFFFHHFFFW
WFFHFF0FFFFFF0FFHFFW
WFFFHHFFFFFFFFHHFFFW
WFFFFFHHHHHHHHFFFFFW
WFFFFFFFFFFFFFFFFFFW
WBFFFFFFFFFFFFFFF3FW
WWWWWWWWWWWWWWWWWWWW
