room_2_2,
COLUMNS=20,LINES=11,
SET_MOB=332233 ,
SPAWN ground: 4-7
SPAWN ground: 4-12
SPAWN flying: 5-9
SPAWN flying: 5-10
SPAWN ground: 6-7
SPAWN ground: 6-12
WWWWWWWWWWWWWWWWWWWW
WJJFFFFFFFFFFFFFFJJW
WJFFFFFFFFFFFFFFFFJW
WFFFBFFFFFFFFFFBFFFW
WFFFBFF3BFFB3FFBFFFW
WFFFBFFFB22BFFFBFFFW
WFFFBFF3BFFB3FFBFFFW
WFFFBFFFFFFFFFFBFFFW
WJFFFFFFFFFFFFFFFFJW
WJJFFFFFFFFFFFFFFJJW
WWWWWWWWWWWWWWWWWWWW
