room_15_4,
COLUMNS=20,LINES=11,
SET_MOB=131 ,
SPAWN ground: 4-15
SPAWN ground: 5-10
SPAWN ground: 6-5
WWWWWWWWWWWWWWWWWWWW
WFJFFFJFFFFFFFFFJFFW
WFHHFFHFFFFFFFBBBFFW
WFHFFFFFFFFFFFFFFBFW
WFHFFFFFFFFFFFF1FBFW
WFFFFFFFFF3FFFFFFFFW
WFFFF1FFFFFFFFFFFFFW
WFHFFFFFFFFFFFFFFBJW
WFHHHFFFFFFFBFFFBBFW
WJFFFFJJJFFFFFFFFFFW
WWWWWWWWWWWWWWWWWWWW
