room_5_2,
COLUMNS=20,LINES=11,
SET_MOB=0110 ,
SPAWN flying: 2-2
SPAWN ground: 2-17
SPAWN ground: 8-2
SPAWN flying: 8-17
WWWWWWWWWWWWWWWWWWWW
WJJFFFFFFFFFFFFFFJJW
WJ0FFFFFFFFFFFFFF1JW
WFFFFBFFFFFFFFBFFFFW
WFFFFBFFFHHFFFBFFFFW
WFFFFBFFHHHHFFBFFFFW
WFFFFBFFFHHFFFBFFFFW
WFFFFBFFFFFFFFBFFFFW
WJ1FFFFFFFFFFFFFF0JW
WJJFFFFFFFFFFFFFFJJW
WWWWWWWWWWWWWWWWWWWW
