room_10_2,
COLUMNS=20,LINES=11,
SET_MOB=2121 ,
SPAWN flying: 1-3
SPAWN ground: 2-16
SPAWN flying: 8-2
SPAWN ground: 8-16
WWWWWWWWWWWWWWWWWWWW
WFF2BFFFFFFBHFFFFFBW
WFFFFFBFFFFFHFFF1BBW
WFFFFFFFFFFFHFFBBBBW
WBFFFFFFFFFFFFFFFFFW
WFFFFFFFFFFFFFFFFFFW
WFFBFFFFBFFFFFFFFFFW
WFFFFFFFFFFFHFFBBBBW
WF2FFFFFFFFFHFFF1BBW
WFFFBFFFFFFFHFFFFFBW
WWWWWWWWWWWWWWWWWWWW
