room_4_1,
COLUMNS=20,LINES=11,
SET_MOB=0000 ,
SPAWN flying: 3-6
SPAWN flying: 3-13
SPAWN flying: 7-6
SPAWN flying: 7-13
WWWWWWWWWWWWWWWWWWWW
WBBFFFFFFFFFFFFFFBBW
WBFFFFFFFFFFFFFFFFBW
WFFFFF0BFFFFB0FFFFFW
WFFFFFBFFFFFFBFFFFFW
WFFFFFBFFFFFFBFFFFFW
WFFFFFBFFFFFFBFFFFFW
WFFFFF0BFFFFB0FFFFFW
WBFFFFFFFFFFFFFFFFBW
WBBFFFFFFFFFFFFFFBBW
WWWWWWWWWWWWWWWWWWWW
