room_6_1,
COLUMNS=20,LINES=11,
SET_MOB=3333 ,
SPAWN ground: 4-6
SPAWN ground: 4-13
SPAWN ground: 6-6
SPAWN ground: 6-13
WWWWWWWWWWWWWWWWWWWW
WBBBBJFFFFFFFFJBBBBW
WJBBJFFFFFFFFFFJBBJW
WFJJFFFFFFFFFFFFJJFW
WFFFFF3BFFFFB3FFFFFW
WFFFFFBHFFFFHBFFFFFW
WFFFFF3BFFFFB3FFFFFW
WFJJFFFFFFFFFFFFJJFW
WJBBJFFFFFFFFFFJBBJW
WBBBBJFFFFFFFFJBBBBW
WWWWWWWWWWWWWWWWWWWW
