room_6_3,
COLUMNS=20,LINES=11,
SET_MOB=2222 ,
SPAWN flying: 2-5
SPAWN flying: 2-14
SPAWN flying: 8-5
SPAWN flying: 8-14
WWWWWWWWWWWWWWWWWWWW
WBBBBJFFFFFFFFJBBBBW
WJBBJ2FFFFFFFF2JBBJW
WFJJFFFFFFFFFFFFJJFW
WFFFFFFFBBBBFFFFFFFW
WFFFFFFFBHHBFFFFFFFW
WFFFFFFFBBBBFFFFFFFW
WFJJFFFFFFFFFFFFJJFW
WJBBJ2FFFFFFFF2JBBJW
WBBBBJFFFFFFFFJBBBBW
WWWWWWWWWWWWWWWWWWWW
