room_11_1,
COLUMNS=20,LINES=11,
SET_MOB=21 ,
SPAWN flying: 1-1
SPAWN ground: 8-17
WWWWWWWWWWWWWWWWWWWW
W2FFFHFFFFFFFFFFFFFW
WFFFFHFFFFFFFFFFFFFW
WHHHHFFFFFFFFFFFFFFW
WFFFFFFFFFFJFFFFFFFW
WFFFFFFFJFFFFFFFFFFW
WBFFFFFFFFJFFFFFFFFW
WBBJFFFFFFFFFFFFFFJW
WBBBFFFFFFFFFFFFF1JW
WBBBBFFFFFFFFFFFJJJW
WWWWWWWWWWWWWWWWWWWW
