room_16_2,
COLUMNS=20,LINES=11,
SET_MOB=03320 ,
SPAWN flying: 1-18
SPAWN ground: 2-1
SPAWN ground: 6-12
SPAWN flying: 8-1
SPAWN flying: 9-18
WWWWWWWWWWWWWWWWWWWW
WFFFHFFFFFFFFFFFFH0W
W3FFFFFFFFFFFFFFFFHW
WBFFFFFFFFFFFFFFFFFW
WFFFFFFFFFFFFFFFFFFW
WFFFFFFFFFFFFFFFFFFW
WFFFFFFFFFFF3FFFFFFW
WBFFFFFFFFFFHFFFFFBW
W2BBFFFFFFFFFFFFBBFW
WFFFBFFFFFFFFFFBFF0W
WWWWWWWWWWWWWWWWWWWW
