room_13_2,
COLUMNS=20,LINES=11,
SET_MOB=3010 ,
SPAWN ground: 2-2
SPAWN flying: 3-12
SPAWN ground: 5-11
SPAWN flying: 9-2
WWWWWWWWWWWWWWWWWWWW
WFFFFFFFFFFFFFFFFFFW
WF3FFFFFFFFFFFFFFBFW
WFFFFFFFFFFF0FFFJBFW
WFFFFFFJFFFFFFFFFBFW
WFFFFFFFFFF1FFFFFHFW
WFFFFFFFFFFFFFFFFHFW
WFFFJFFFFFFFFFFFFHFW
WFBBBHHHHHHHHHHHHFFW
WF0FFFFFFFFFFFFFFFFW
WWWWWWWWWWWWWWWWWWWW
