room_10_3,
COLUMNS=20,LINES=11,
SET_MOB=1012 ,
SPAWN ground: 2-16
SPAWN flying: 4-3
SPAWN ground: 8-16
SPAWN flying: 9-4
WWWWWWWWWWWWWWWWWWWW
WFFFFFFHFFFFHFFFFFBW
WFBFFFFHFFFFHFFF1BBW
WFFFBFFHFFFFHFFBBBBW
WFF0FFFFFFFFFFFFFFFW
WFFJFFFFFFFFFFBFFFFW
WFFFFFFFFFFFFFFFFFFW
WFFFFBFHFFFFHFFBBBBW
WFBFFFFHFFFFHFFF1BBW
WFFF2FFHFFFFHFFFFFBW
WWWWWWWWWWWWWWWWWWWW
