room_9_2,
COLUMNS=20,LINES=11,
SET_MOB=21221 ,
SPAWN flying: 1-18
SPAWN ground: 2-1
SPAWN flying: 9-1
SPAWN flying: 9-2
SPAWN ground: 9-18
WWWWWWWWWWWWWWWWWWWW
WFFFHFFFFFFFFBFFFF2W
W1FFFFFFFFFFFBFBBBBW
WHHHHFFFFFFFFFFFFFFW
WFFFFFFFFJFFFFFFFFFW
WFFFFFFFFFJFFFFFFFFW
WFFFFFFFFFFFFFFFFFFW
WBBBBBFBFFFFFFFFFFFW
WFFFFFFBFFFFFFFHHHHW
W22FFFFBFFFFFFFFFF1W
WWWWWWWWWWWWWWWWWWWW
