room_16_3,
COLUMNS=20,LINES=11,
SET_MOB=2020 ,
SPAWN flying: 1-18
SPAWN flying: 3-6
SPAWN flying: 8-1
SPAWN flying: 9-18
WWWWWWWWWWWWWWWWWWWW
WFFFHFFFFFFFFFFFFH2W
WFJFFFFFFFFFFFFFFFHW
WFFFFF0FJFFFJFFFFFFW
WFFFFFFFFFFFFFFFFFFW
WFFFFFFFFJJFFFFFFFFW
WFFFFFFFFFJFJFFFFFFW
WBFFFFFJFFFFFFFFFFBW
W2BBFFFFFFFFFFFFBBFW
WFFFBFFFFFFFFFFBFF0W
WWWWWWWWWWWWWWWWWWWW
