room_20_2,
COLUMNS=20,LINES=11,
SET_MOB=2132 ,
SPAWN flying: 1-1
SPAWN ground: 3-12
SPAWN ground: 7-12
SPAWN flying: 9-4
WWWWWWWWWWWWWWWWWWWW
W2FHJJFJFFFBFFFFFFFW
WFHJFFFFFFFJBFFFFFFW
WHHFFFFFFFFF1BBBFFFW
WFFFFFFFFFFFFFFFBBBW
WFFFFFFFFJFFFFFFFFFW
WFFFFFFFFFFFFFFFBBBW
WHFFFFJFFFFF3BBBFFFW
WFHHHHHFFFFJBFFFFFFW
WFFF2FHFFFFBFFFFFFFW
WWWWWWWWWWWWWWWWWWWW
