room_14_4,
COLUMNS=20,LINES=11,
SET_MOB=0132 ,
SPAWN flying: 3-5
SPAWN ground: 3-12
SPAWN ground: 8-5
SPAWN flying: 9-12
WWWWWWWWWWWWWWWWWWWW
WFFFFFFFBFFBFFFFBFFW
WFFFFFFFHFFHFFFFBFFW
WHHFF0FFHFFH1FFFBFFW
WFFHHHHHHFFHHHHHHFFW
WFFFFFFFFFFFFFFFFFFW
WJJFFFFFFFFFFFFFFFFW
WBBJFFFFFFFFFFBFFFFW
WBBBJ3FFFFFFFFFFFFFW
WBBBBJFFFFFF2FFFFFFW
WWWWWWWWWWWWWWWWWWWW
