room_11_4,
COLUMNS=20,LINES=11,
SET_MOB=2102 ,
SPAWN flying: 1-18
SPAWN ground: 2-2
SPAWN flying: 9-1
SPAWN flying: 9-14
WWWWWWWWWWWWWWWWWWWW
WJJJFJFFFFFFFFFBBB2W
WJ1JFFFFFFFFFFFFBBBW
WJJJFFFFFFFJFFFFFBBW
WJFJFFJFFFFFFFFFFFBW
WFFFFFFFFFFFFFFJFFFW
WFFFFFFFFFFFFFFFFFFW
WHHHFFFFFFFFFFFFFFFW
WFFFHFFFFJFFHHHHFFFW
W0FFHFFFFFFFHF2HFFFW
WWWWWWWWWWWWWWWWWWWW
