room_14_2,
COLUMNS=20,LINES=11,
SET_MOB=33012 ,
SPAWN ground: 1-15
SPAWN ground: 2-5
SPAWN flying: 7-5
SPAWN ground: 7-12
SPAWN flying: 9-17
WWWWWWWWWWWWWWWWWWWW
WBBBBFFFFFFFFFF3JJJW
WBBBF3FFFFFFFFFFFJJW
WBBFFFFFFFFFFFFFFFJW
WFFFFFFFFFFFFFFFFFFW
WFFFFFFFFFFFFFFFFFFW
WBHHHHHHHFFHHHHHHHBW
WFFFF0FFHFFH1FFFFFFW
WFFFFFFFHFFHFFFFFFFW
WFFFFFFFBFFBFFFFF2FW
WWWWWWWWWWWWWWWWWWWW
