room_3_1,
COLUMNS=20,LINES=11,
SET_MOB=222222 ,
SPAWN flying: 4-7
SPAWN flying: 4-12
SPAWN flying: 5-9
SPAWN flying: 5-10
SPAWN flying: 6-7
SPAWN flying: 6-12
WWWWWWWWWWWWWWWWWWWW
WJJFFFFFFFFFFFFFFJJW
WJFFFFFFFFFFFFFFFFJW
WFFFFFFFFFFFFFFFFFFW
WFFFFFF2FFFF2FFFFFFW
WFFFFFFFF22FFFFFFFFW
WFFFFFF2FFFF2FFFFFFW
WFFFFFFFFFFFFFFFFFFW
WJFFFFFFFFFFFFFFFFJW
WJJFFFFFFFFFFFFFFJJW
WWWWWWWWWWWWWWWWWWWW
