room_20_3,
COLUMNS=20,LINES=11,
SET_MOB=201302 ,
SPAWN flying: 1-1
SPAWN flying: 1-17
SPAWN ground: 3-12
SPAWN ground: 7-12
SPAWN flying: 8-15
SPAWN flying: 9-4
WWWWWWWWWWWWWWWWWWWW
W2FBJJFJFFFHFFFFF0FW
WFFBBFFFFFFJHFFFFFFW
WBBFFFFFFFFF1HHHFFFW
WFFFFFFFFFFFFFFFHHHW
WFFFFFFFFJFFFFFFFFFW
WFFBFFFFFFFFFFFFHHHW
WBFFFBBFFFFF3HHHFFFW
WFBBBFBFFFFJHFF0FFFW
WFFF2FBFFFFHFFFFFFFW
WWWWWWWWWWWWWWWWWWWW
