room_17_2,
COLUMNS=20,LINES=11,
SET_MOB=021120 ,
SPAWN flying: 4-8
SPAWN flying: 4-11
SPAWN ground: 5-4
SPAWN ground: 5-15
SPAWN flying: 6-9
SPAWN flying: 6-12
WWWWWWWWWWWWWWWWWWWW
WJFFFFFFFFFFFFFFFJJW
WFFFFFHHHHHHHHJFFFJW
WFFFJHFFFFFFFFHFFFFW
WFFFHFHF0FF2FHFHFFFW
WFFH1FFHFFFFHFF1HFFW
WFFFHFHFF2FF0HFHFFFW
WFFFFHFFFFFFFFHFFFFW
WJFFFFHHHHHHHHFJFFFW
WJFFFFFFFFFFFFFFFFJW
WWWWWWWWWWWWWWWWWWWW
