room_13_3,
COLUMNS=20,LINES=11,
SET_MOB=2112 ,
SPAWN flying: 2-2
SPAWN ground: 5-9
SPAWN ground: 6-6
SPAWN flying: 8-17
WWWWWWWWWWWWWWWWWWWW
WFFFFFFFFFFFFFFFFFFW
WF2FFFFFFFFFFFFFFBFW
WFFFFFFFFFFFFFFFJBFW
WFBFFFFJFFFFFFFFFBFW
WFBFFFFFF1FFFFFFFHFW
WFBFFF1FFFFFFFFFFHFW
WFFFJFFFFFFFFFFFFFFW
WFBBBHHHHHHHHHHHF2FW
WFFFFFFFFFFFFFFFFFFW
WWWWWWWWWWWWWWWWWWWW
