room_8_4,
COLUMNS=20,LINES=11,
SET_MOB=0000 ,
SPAWN flying: 3-8
SPAWN flying: 3-10
SPAWN flying: 7-9
SPAWN flying: 7-11
WWWWWWWWWWWWWWWWWWWW
WFFFFFFFFFFFFFFFFFFW
WFBBFFFFBBBBFFFFBBFW
WFBFFFFF0F0HFFFFFBFW
WFFFFFFFFFFHFFFFFFFW
WFFFFFFFFHHFFFFFFFFW
WFFFFFFFHFFFFFFFFFFW
WFBFFFFFH0F0FFFFFBFW
WFBBFFFFBBBBFFFFBBFW
WFFFFFFFFFFFFFFFFFFW
WWWWWWWWWWWWWWWWWWWW
