room_9_4,
COLUMNS=20,LINES=11,
SET_MOB=12212 ,
SPAWN ground: 1-1
SPAWN flying: 1-17
SPAWN flying: 1-18
SPAWN ground: 8-18
SPAWN flying: 9-1
WWWWWWWWWWWWWWWWWWWW
W1FFFFFFFFFFBFFFF22W
WHHHHFFFFFFFBFFFFFFW
WFFFFFFFFFFFBFBBBBBW
WFFFFFFFFFFFFFFFFFFW
WFFFFFFFFJFFFFFFFFFW
WFFFFFFFFFJFFFFFFFFW
WFFFFFFFFFFFFFFHHHHW
WBBBBFBFFFFFFFFFFF1W
W2FFFFBFFFFFFFFHFFFW
WWWWWWWWWWWWWWWWWWWW
