room_17_1,
COLUMNS=20,LINES=11,
SET_MOB=0220 ,
SPAWN flying: 4-8
SPAWN flying: 4-11
SPAWN flying: 6-9
SPAWN flying: 6-12
WWWWWWWWWWWWWWWWWWWW
WJFFFFFFFFFFFFFFFJJW
WFFFFFHHHHHHHHFFFFJW
WFFFFHFFFFFFFFHFFFFW
WFFFHFFF0FF2FFFHFFFW
WFFHFFFFFFFFFFFFHFFW
WFFFHFFFF2FF0FFHFFFW
WFFFFHFFFFFFFFHFFFFW
WJFFFFHHHHHHHHFFFFFW
WJFFFFFFFFFFFFFFFFJW
WWWWWWWWWWWWWWWWWWWW
