room_20_1,
COLUMNS=20,LINES=11,
SET_MOB=2312 ,
SPAWN flying: 1-15
SPAWN ground: 3-7
SPAWN ground: 7-7
SPAWN flying: 9-18
WWWWWWWWWWWWWWWWWWWW
WFFFFFFFBFFFFHF2FFFW
WFFFFFFBFFFFFHHHHHFW
WFFFBBB3FFFFFHFFFFHW
WBBBFFFFFFFFFFFFFFFW
WFFFFFFFFFFFFFFFFFFW
WBBBFFFFFFFFFFFFFFFW
WFFFBBB1FFFFFFFFFHHW
WFFFFFFBFFFFFFFFFHFW
WFFFFFFFBFFFFFFFHF2W
WWWWWWWWWWWWWWWWWWWW
