room_4_4,
COLUMNS=20,LINES=11,
SET_MOB=112211 ,
SPAWN ground: 3-6
SPAWN ground: 3-13
SPAWN flying: 4-9
SPAWN flying: 6-10
SPAWN ground: 7-6
SPAWN ground: 7-13
WWWWWWWWWWWWWWWWWWWW
WBBJJJFFFFFFFFJJJBBW
WBFFFFFFFFFFFFFFFFBW
WFFFFF1BFFFFB1FFFFFW
WFBBFFBFF2FFFBFFBBFW
WFFBHHBFFFFFFBHHBFFW
WFBBFFBFFF2FFBFFBBFW
WFFFFF1BFFFFB1FFFFFW
WBFFFFFFFFFFFFFFFFBW
WBBJJJFFFFFFFFJJJBBW
WWWWWWWWWWWWWWWWWWWW
