room_18_4,
COLUMNS=20,LINES=11,
SET_MOB=011310 ,
SPAWN flying: 1-3
SPAWN ground: 3-16
SPAWN ground: 5-10
SPAWN ground: 6-9
SPAWN ground: 8-4
SPAWN flying: 9-18
WWWWWWWWWWWWWWWWWWWW
WBB0BFFFFFFFHBFFFHHW
WBBBFFFFFFFFFHHFFFFW
WFBFFFFFFFFFFFFH1FFW
WFFFFFFFFFFFFFFFHHHW
WFFFFFFFFF1FFFFFJFFW
WHHHFFFFF3FFFFFFFFFW
WFFFHFFFFFFJFFFFFFFW
WFBF1HHFFFFFFFFFJFJW
WHHFFFFHFFFJFFJJJJ0W
WWWWWWWWWWWWWWWWWWWW
