room_7_3,
COLUMNS=20,LINES=11,
SET_MOB=000000 ,
SPAWN flying: 1-1
SPAWN flying: 1-18
SPAWN flying: 5-9
SPAWN flying: 5-10
SPAWN flying: 9-1
SPAWN flying: 9-18
WWWWWWWWWWWWWWWWWWWW
W0BBBBFFFFFFFFBBBB0W
WBBBFFFFFFFFFFFFBBBW
WBFFFFFFFFFFFFFFFFBW
WFFFFFFFFHHFFFFFFFFW
WFFFFFFFH00HFFFFFFFW
WFFFFFFFFHHFFFFFFFFW
WBFFFFFFFFFFFFFFFFBW
WBBBFFFFFFFFFFFFBBBW
W0BBBBFFFFFFFFBBBB0W
WWWWWWWWWWWWWWWWWWWW
