room_5_1,
COLUMNS=20,LINES=11,
SET_MOB=2112 ,
SPAWN flying: 2-2
SPAWN ground: 2-17
SPAWN ground: 8-2
SPAWN flying: 8-17
WWWWWWWWWWWWWWWWWWWW
WFFFFFFFFFFFFFFFFFFW
WF2FFFFFFFFFFFFFF1FW
WFFFFFFFFFFFFFFFFFFW
WFFFFFFFFHHFFFFFFFFW
WFFFFFFFHHHHFFFFFFFW
WFFFFFFFFHHFFFFFFFFW
WFFFFFFFFFFFFFFFFFFW
WF1FFFFFFFFFFFFFF2FW
WFFFFFFFFFFFFFFFFFFW
WWWWWWWWWWWWWWWWWWWW
