room_5_1,
COLUMNS=20,LINES=11,
SET_MOB=2112 ,
SPAWN flying: 2-2
SPAWN ground: 2-17
SPAWN ground: 8-2
SPAWN flying: 8-17
WWWWWWWWWWWWWWWWWWWW
WJJFFFFFFFFFFFFFFJJW
WJ2FFFFFFFFFFFFFF1JW
WFFFFFFFFFFFFFFFFFFW
WFFFFFFFFHHFFFFFFFFW
WFFFFFFFHHHHFFFFFFFW
WFFFFFFFFHHFFFFFFFFW
WFFFFFFFFFFFFFFFFFFW
WJ1FFFFFFFFFFFFFF2JW
WJJFFFFFFFFFFFFFFJJW
WWWWWWWWWWWWWWWWWWWW
