room_19_1,
COLUMNS=20,LINES=11,
SET_MOB=1010 ,
SPAWN ground: 1-2
SPAWN flying: 2-14
SPAWN ground: 9-4
SPAWN flying: 9-17
WWWWWWWWWWWWWWWWWWWW
WF1HFHFFHFFFFHFFHFFW
WFFHFHFFHFFFFH0FHHHW
WJHHFHHHFFFFFHHHFFFW
WFFFFFFFFBBFFFFFFFFW
WFFFFFFFBFFBFFFFFFFW
WFFFFFFFFBBFFFFFFFFW
WFFFFFFFFFFFFFFFFFJW
WHHFHHHFFFFFFFFJJJJW
WFFJ1FFHFFFFFFJBB0BW
WWWWWWWWWWWWWWWWWWWW
