room_20_4,
COLUMNS=20,LINES=11,
SET_MOB=20102 ,
SPAWN flying: 1-15
SPAWN flying: 2-4
SPAWN ground: 5-10
SPAWN flying: 9-2
SPAWN flying: 9-18
WWWWWWWWWWWWWWWWWWWW
WFFFFFFFHFFFFBF2FFFW
WFFF0FFHFFFFFBFBBBFW
WFFFHHHFFFFFFBBFFFBW
WHHHFFFFFFFFFFFFBFFW
WFFFFFFFFF1FFFFFFFFW
WHHHFFFFFFFFFFFFFFFW
WFFFHHHFFFFFFFFFFBBW
WFFFFFFHFFFFFFFBBFFW
WF0FFFFFHFFFFFFFBF2W
WWWWWWWWWWWWWWWWWWWW
