room_6_4,
COLUMNS=20,LINES=11,
SET_MOB=22 ,
SPAWN flying: 2-14
SPAWN flying: 8-5
WWWWWWWWWWWWWWWWWWWW
WBBBBJFFFFFFFFJBBBBW
WJBBJFFFFFFFFF2JBBJW
WFJJFFFFFFFFFFFFJJFW
WFFFFFFFBBBBFFFFFFFW
WFFFFFFFBHHBFFFFFFFW
WFFFFFFFBBBBFFFFFFFW
WFJJFFFFFFFFFFFFJJFW
WJBBJ2FFFFFFFFFJBBJW
WBBBBJFFFFFFFFJBBBBW
WWWWWWWWWWWWWWWWWWWW
