room_14_3,
COLUMNS=20,LINES=11,
SET_MOB=2301 ,
SPAWN flying: 1-12
SPAWN ground: 2-5
SPAWN flying: 7-5
SPAWN ground: 7-12
WWWWWWWWWWWWWWWWWWWW
WBBBBJFFFFFF2FFFFFFW
WBBBJ3FFFFFFFFFFFFFW
WBBJFFFFFFFFFFFFFFFW
WJJFFFFFFFFFFFFFFFFW
WFFFFFFFFFFFFFFFFFFW
WFFHHHHHHFFHHHHHHFFW
WHHFF0FFHFFH1FFFFHHW
WFFFFFFFHFFHFFFFFFFW
WFFFFFFFBFFBFFFFFFFW
WWWWWWWWWWWWWWWWWWWW
