room_12_3,
COLUMNS=20,LINES=11,
SET_MOB=110 ,
SPAWN ground: 1-2
SPAWN ground: 1-17
SPAWN flying: 6-5
WWWWWWWWWWWWWWWWWWWW
WB1FFFFFFFFFFFFFF1BW
WBBFFFFFFFFFFFFFFBBW
WFBBBFFFFFFFFFFBBBFW
WFFFBBBBFFFFBBBBFFFW
WFFFFFFFFFFFFFFFFFFW
WFFFF0FFFFFFFFFFFFFW
WHFFFFFFFFFFFFFFFFFW
WFHFFFFFFFFFFFFFFFFW
WFFHFFFFFFFFFFFFFFFW
WWWWWWWWWWWWWWWWWWWW
