room_12_4,
COLUMNS=20,LINES=11,
SET_MOB=3011 ,
SPAWN ground: 2-11
SPAWN flying: 4-5
SPAWN ground: 9-2
SPAWN ground: 9-17
WWWWWWWWWWWWWWWWWWWW
WFFHFFFFFFFFFHFFFFFW
WFHFFFFFFFF3FFHHHFFW
WHFFFFFFFFFFFFFFFHHW
WFFFF0FFFFFFFFFFFFFW
WFFFFFFFFFFFFFFFFFFW
WFFFBBBBFFFFBBBBFFFW
WFBBBFFFFFFFFFFBBBFW
WBBFFFFFFFFFFFFFFBBW
WB1FFFFFFFFFFFFFF1BW
WWWWWWWWWWWWWWWWWWWW
