room_2_4,
COLUMNS=20,LINES=11,
SET_MOB=22 ,
SPAWN flying: 5-9
SPAWN flying: 5-10
WWWWWWWWWWWWWWWWWWWW
WJJFFFFFFFFFFFFFFJJW
WJFFFFFFBBBBFFFFFFJW
WFFFBFFFFFFFFFFBFFFW
WFFFBFFFFFFFFFFBFFFW
WFFFHFFBF22FBFFHFFFW
WFFFBFFFFFFFFFFBFFFW
WFFFBFFFFFFFFFFBFFFW
WJFFFFFFBBBBFFFFFFJW
WJJFFFFFFFFFFFFFFJJW
WWWWWWWWWWWWWWWWWWWW
