room_4_2,
COLUMNS=20,LINES=11,
SET_MOB=0000 ,
SPAWN flying: 3-6
SPAWN flying: 3-13
SPAWN flying: 7-6
SPAWN flying: 7-13
WWWWWWWWWWWWWWWWWWWW
WBBFFFFFFFFFFFFFFBBW
WBFFFFFFFFFFFFFFFFBW
WFFFFH0BFFFFB0HFFFFW
WFFFFHBHFFFFHBHFFFFW
WFFFHHBHFFFFHBHHFFFW
WFFFFHBHFFFFHBHFFFFW
WFFFFH0BFFFFB0HFFFFW
WBFFFFFFFFFFFFFFFFBW
WBBFFFFFFFFFFFFFFBBW
WWWWWWWWWWWWWWWWWWWW
